first_name	last_name	email
Berke	de Marco	bdemarco0@salon.com
Stacia	Frankcom	sfrankcom1@studiopress.com
Brnaba	Raubenheimers	braubenheimers2@biblegateway.com
Archy	Selby	aselby3@biblegateway.com
Hildagarde	Fair	hfair4@house.gov
Ignatius	Widdecombe	iwiddecombe5@dot.gov
Sascha	Mariel	smariel6@discuz.net
Wiley	O'Hoey	wohoey7@infoseek.co.jp
Francene	Weymont	fweymont8@prlog.org
Aggi	Lightman	alightman9@umich.edu
Nanette	Nangle	nnanglea@eepurl.com
Shepherd	Brougham	sbroughamb@washington.edu
Giffer	Dowsing	gdowsingc@themeforest.net
Garfield	Kuhwald	gkuhwaldd@tumblr.com
Tansy	Korb	tkorbe@timesonline.co.uk
Alyss	Fatharly	afatharlyf@mac.com
Brittne	Gunby	bgunbyg@e-recht24.de
Fae	Brook	fbrookh@godaddy.com
Agace	Creech	acreechi@privacy.gov.au
Lowe	MacLeese	lmacleesej@surveymonkey.com
Terri	Fumagallo	tfumagallok@angelfire.com
Janeta	Van Leeuwen	jvanleeuwenl@usnews.com
Kahaleel	Aldred	kaldredm@nsw.gov.au
Boris	Claxton	bclaxtonn@sakura.ne.jp
Laureen	Steffan	lsteffano@state.tx.us
